500,200,300,700,800,450,550,300,450,550,700
100,200,200,200,200,350,350,500,500,500,500
0,1,0,0,1,0,0,0,0,0,0 
1,0,1,0,0,0,0,0,0,0,0
0,1,0,1,0,0,0,1,0,0,0
0,0,1,0,1,0,0,0,0,0,1
1,0,0,1,0,0,0,0,0,0,0
0,0,0,0,0,0,1,0,1,0,0
0,0,0,0,0,1,0,0,0,1,0
0,0,1,0,0,0,0,0,1,0,0
0,0,0,0,0,1,0,1,0,0,0
0,0,0,0,0,0,1,0,0,0,1
0,0,0,1,0,0,0,0,0,1,0 