500,100,350,650,900,100,350,650,900,500
100,200,200,200,200,400,400,400,400,500
0,0,1,1,0,0,0,0,0,0
0,0,1,0,0,0,1,0,0,0
1,1,0,1,0,1,0,0,0,0
1,0,1,0,1,0,0,0,1,0
0,0,0,1,0,0,0,1,0,0
0,0,1,0,0,0,1,0,0,0
0,1,0,0,0,1,0,1,0,1
0,0,0,0,1,0,1,0,1,1
0,0,0,1,0,0,0,1,0,0
0,0,0,0,0,0,1,1,0,0