400,600,300,700,300,700,400,600
100,100,200,200,400,400,500,500
0,1,1,0,0,1,1,0
1,0,0,1,1,0,0,1
1,0,0,1,1,0,0,1
0,1,1,0,0,1,1,0
0,1,1,0,0,1,1,0
1,0,0,1,1,0,0,1
1,0,0,1,1,0,0,1
0,1,1,0,0,1,1,0